000000000000000
000000000000000
000000000000000
000000000000000
333333333333333
322222222222223
322222222222223
322222222222223
322222222222223
333333333333333
000000000000000
000000000000000
333333333333333
000000000000000
000000000000000
000000000000000
000000000000000
000000000000000
000000000000000
000000000000000
000000000000000
000000000000000
000000000000000
000000000000000
000000000000000
000000000000000
000000000000000
000000000000000
000000000000000
000000000000000