000000000000000
000000000000000
001000000000100
001000000000100
001000000000100
001000000000100
001000000000100
001000333000100
001000222000100
001000222000100
001000222000100
001000333000100
001000000000100
001000000000100
001000000000100
001000000000100
001000000000100
001000000000100
001111000111100
000000000000000
000000000000000
000000000000000
000000000000000
000000000000000
000000000000000
000000000000000
000000000000000
000000000000000
000000000000000
000000000000000