300000000000000
300000000000000
300333333333300
300300000000300
300300000000300
300322222300300
300322222300300
300322222300300
300322222300300
300322222300300
300322222300300
300333333300300
300000000000300
300000000000300
333333333333300
000000000000000
000000000000000
000000000000000
000000000000000
000000000000000
000000000000000
000000000000000
000000000000000
000000000000000
000000000000000
000000000000000
000000000000000
000000000000000
000000000000000
000000000000000